NO assets/wall-enhanced_1.xpm
SO assets/wall-enhanced_1.xpm
WE assets/wall-enhanced_1.xpm
EA assets/wall-enhanced_1.xpm
DO assets/door-enhanced_1.xpm
F 18,18,22
C 8,28,42

11111111111111111111111111111
1E000000000000000000000000001
10000002000000000000000000001
10000000000100001111110000001
10000000001100000000011000001
100000000D0100000000011000001
10000000100100000000110000001
10000001000100000001100000001
10000012000100000011000000001
1000011111D100000110000000001
10000000000100001100000000001
10000000000100011111111000001
10000000000000000000000000001
10000000000000000000000000001
11111111111111111111111111111

